onset,terminus,vertex.id,onset.censored,terminus.censored,duration
432,623,10,FALSE,FALSE,191
624,815,11,FALSE,FALSE,191
816,1007,9,FALSE,FALSE,191
1008,1103,7,FALSE,FALSE,95
1104,1295,3,FALSE,FALSE,191
1296,1487,11,FALSE,FALSE,191
1488,1583,9,FALSE,FALSE,95
1584,1775,10,FALSE,FALSE,191
1776,1967,11,FALSE,FALSE,191
1968,2159,12,FALSE,FALSE,191
2160,2351,10,FALSE,FALSE,191
2352,2543,9,FALSE,FALSE,191
2544,2735,10,FALSE,FALSE,191
2928,3311,11,FALSE,FALSE,383
3312,3599,11,FALSE,FALSE,287
3600,3647,10,FALSE,FALSE,47
3648,3695,9,FALSE,FALSE,47
3696,4079,10,FALSE,FALSE,383
4080,4271,11,FALSE,FALSE,191
4272,4559,10,FALSE,FALSE,287
4560,4751,13,FALSE,FALSE,191
4752,4895,12,FALSE,FALSE,143
4896,4943,11,FALSE,FALSE,47
4944,5135,11,FALSE,FALSE,191
5136,5231,10,FALSE,FALSE,95
5232,5327,11,FALSE,FALSE,95
5328,5423,8,FALSE,FALSE,95
5424,5519,10,FALSE,FALSE,95
5520,5615,7,FALSE,FALSE,95
5616,5807,6,FALSE,FALSE,191
5904,5999,10,FALSE,FALSE,95
6000,6095,8,FALSE,FALSE,95
6096,6191,6,FALSE,FALSE,95
6192,6287,7,FALSE,FALSE,95
6288,6479,11,FALSE,FALSE,191
6480,6575,8,FALSE,FALSE,95
6576,6671,10,FALSE,FALSE,95
6672,6863,11,FALSE,FALSE,191
6864,6959,13,FALSE,FALSE,95
6960,7151,12,FALSE,FALSE,191
7152,7343,11,FALSE,FALSE,191
7344,7535,10,FALSE,FALSE,191
7536,7727,9,FALSE,FALSE,191
7728,8015,10,FALSE,FALSE,287
8016,8159,11,FALSE,FALSE,143
8160,8207,10,FALSE,FALSE,47
8208,8303,7,FALSE,FALSE,95
8304,8399,5,FALSE,FALSE,95
8400,8495,10,FALSE,FALSE,95
8496,8591,11,FALSE,FALSE,95
8592,8783,13,FALSE,FALSE,191
8784,8879,12,FALSE,FALSE,95
8880,9071,13,FALSE,FALSE,191
9072,9263,12,FALSE,FALSE,191
9264,9455,11,FALSE,FALSE,191
9552,9743,10,FALSE,FALSE,191
9744,9839,11,FALSE,FALSE,95
9840,10031,9,FALSE,FALSE,191
10032,10223,10,FALSE,FALSE,191
10224,10319,11,FALSE,FALSE,95
10320,10463,13,FALSE,FALSE,143
10464,10511,12,FALSE,FALSE,47
10512,10607,10,FALSE,FALSE,95
10608,10799,11,FALSE,FALSE,191
10800,10895,12,FALSE,FALSE,95
10896,11183,10,FALSE,FALSE,287
11184,11279,12,FALSE,FALSE,95
11280,11375,13,FALSE,FALSE,95
11376,11567,14,FALSE,FALSE,191
11568,11663,13,FALSE,FALSE,95
11664,11807,12,FALSE,FALSE,143
11808,11855,10,FALSE,FALSE,47
11856,11951,11,FALSE,FALSE,95
11952,12143,12,FALSE,FALSE,191
12144,12335,11,FALSE,FALSE,191
12336,12527,10,FALSE,FALSE,191
12528,12719,9,FALSE,FALSE,191
12720,12815,10,FALSE,FALSE,95
12816,12863,5,FALSE,FALSE,47
12864,12911,6,FALSE,FALSE,47
12912,12959,7,FALSE,FALSE,47
12960,13007,8,FALSE,FALSE,47
13008,13391,10,FALSE,FALSE,383
13488,13583,5,FALSE,FALSE,95
13584,13679,4,FALSE,FALSE,95
13680,13775,2,FALSE,FALSE,95
13776,13871,1,FALSE,FALSE,95
13872,13967,2,FALSE,FALSE,95
13968,14159,10,FALSE,FALSE,191
14160,14255,9,FALSE,FALSE,95
14256,14639,10,FALSE,FALSE,383
15600,15791,10,FALSE,FALSE,191
15792,15983,11,FALSE,FALSE,191
15984,16175,12,FALSE,FALSE,191
16176,16367,12,FALSE,FALSE,191
16368,16559,12,FALSE,FALSE,191
16560,16943,12,FALSE,FALSE,383
16944,17135,13,FALSE,FALSE,191
17136,17327,13,FALSE,FALSE,191
17328,17519,12,FALSE,FALSE,191
17520,17711,12,FALSE,FALSE,191
17712,17855,12,FALSE,FALSE,143
17856,17903,11,FALSE,FALSE,47
17904,17999,12,FALSE,FALSE,95
18000,18191,13,FALSE,FALSE,191
18192,18383,12,FALSE,FALSE,191
18384,18479,11,FALSE,FALSE,95
18480,18575,12,FALSE,FALSE,95
18576,18767,13,FALSE,FALSE,191
18768,18815,12,FALSE,FALSE,47
18816,18863,11,FALSE,FALSE,47
18864,19007,10,FALSE,FALSE,143
19008,19055,9,FALSE,FALSE,47
19056,19439,11,FALSE,FALSE,383
19440,19631,12,FALSE,FALSE,191
19632,19919,13,FALSE,FALSE,287
19920,19967,12,FALSE,FALSE,47
19968,20015,11,FALSE,FALSE,47
20016,20207,10,FALSE,FALSE,191
20208,20399,13,FALSE,FALSE,191
20400,20591,13,FALSE,FALSE,191
20592,20783,12,FALSE,FALSE,191
20784,20927,10,FALSE,FALSE,143
20928,20975,11,FALSE,FALSE,47
20976,21167,12,FALSE,FALSE,191
21168,21311,13,FALSE,FALSE,143
21312,21359,11,FALSE,FALSE,47
21360,21455,12,FALSE,FALSE,95
21456,21839,10,FALSE,FALSE,383
21840,21935,9,FALSE,FALSE,95
21936,22031,10,FALSE,FALSE,95
22032,22223,11,FALSE,FALSE,191
22224,22319,10,FALSE,FALSE,95
22320,22511,11,FALSE,FALSE,191
22512,22703,7,FALSE,FALSE,191
22896,23087,8,FALSE,FALSE,191
23088,23279,10,FALSE,FALSE,191
23280,23375,7,FALSE,FALSE,95
23376,23519,11,FALSE,FALSE,143
23520,23543,10,FALSE,FALSE,23
23544,23567,9,FALSE,FALSE,23
23568,23663,7,FALSE,FALSE,95
23664,23807,10,FALSE,FALSE,143
23808,23831,9,FALSE,FALSE,23
23832,23855,7,FALSE,FALSE,23
23856,23951,6,FALSE,FALSE,95
23952,24143,5,FALSE,FALSE,191
24144,24335,10,FALSE,FALSE,191
24336,24431,9,FALSE,FALSE,95
24432,24815,10,FALSE,FALSE,383
25440,25631,10,FALSE,FALSE,191
25632,25823,11,FALSE,FALSE,191
25824,26015,9,FALSE,FALSE,191
26016,26111,7,FALSE,FALSE,95
26112,26303,3,FALSE,FALSE,191
26304,26495,11,FALSE,FALSE,191
26496,26591,9,FALSE,FALSE,95
26592,26783,10,FALSE,FALSE,191
26784,26975,11,FALSE,FALSE,191
26976,27167,12,FALSE,FALSE,191
27168,27359,10,FALSE,FALSE,191
27360,27551,9,FALSE,FALSE,191
27552,27743,10,FALSE,FALSE,191
27936,28319,11,FALSE,FALSE,383
28320,28607,11,FALSE,FALSE,287
28608,28655,10,FALSE,FALSE,47
28656,28703,9,FALSE,FALSE,47
28704,29087,10,FALSE,FALSE,383
29088,29279,11,FALSE,FALSE,191
29280,29567,10,FALSE,FALSE,287
29568,29759,13,FALSE,FALSE,191
29760,29903,12,FALSE,FALSE,143
29904,29951,11,FALSE,FALSE,47
29952,30143,11,FALSE,FALSE,191
30144,30239,10,FALSE,FALSE,95
30240,30335,11,FALSE,FALSE,95
30336,30431,8,FALSE,FALSE,95
30432,30527,10,FALSE,FALSE,95
30528,30623,7,FALSE,FALSE,95
30624,30815,6,FALSE,FALSE,191
30912,31007,10,FALSE,FALSE,95
31008,31103,8,FALSE,FALSE,95
31104,31199,6,FALSE,FALSE,95
31200,31295,7,FALSE,FALSE,95
31296,31487,11,FALSE,FALSE,191
31488,31583,8,FALSE,FALSE,95
31584,31679,10,FALSE,FALSE,95
31680,31871,11,FALSE,FALSE,191
31872,31967,13,FALSE,FALSE,95
31968,32159,12,FALSE,FALSE,191
32160,32351,11,FALSE,FALSE,191
32352,32543,10,FALSE,FALSE,191
32544,32735,9,FALSE,FALSE,191
32736,33023,10,FALSE,FALSE,287
33024,33167,11,FALSE,FALSE,143
33168,33215,10,FALSE,FALSE,47
33216,33311,7,FALSE,FALSE,95
33312,33407,5,FALSE,FALSE,95
33408,33503,10,FALSE,FALSE,95
33504,33599,11,FALSE,FALSE,95
33600,33791,13,FALSE,FALSE,191
33792,33887,12,FALSE,FALSE,95
33888,34079,13,FALSE,FALSE,191
34080,34271,12,FALSE,FALSE,191
34272,34463,11,FALSE,FALSE,191
34560,34751,10,FALSE,FALSE,191
34752,34847,11,FALSE,FALSE,95
34848,35039,9,FALSE,FALSE,191
35040,35231,10,FALSE,FALSE,191
35232,35327,11,FALSE,FALSE,95
35328,35471,13,FALSE,FALSE,143
35472,35519,12,FALSE,FALSE,47
35520,35615,10,FALSE,FALSE,95
35616,35807,11,FALSE,FALSE,191
35808,35903,12,FALSE,FALSE,95
35904,36191,10,FALSE,FALSE,287
36192,36287,12,FALSE,FALSE,95
36288,36383,13,FALSE,FALSE,95
36384,36575,14,FALSE,FALSE,191
36576,36671,13,FALSE,FALSE,95
36672,36815,12,FALSE,FALSE,143
36816,36863,10,FALSE,FALSE,47
36864,36959,11,FALSE,FALSE,95
36960,37151,12,FALSE,FALSE,191
37152,37343,11,FALSE,FALSE,191
37344,37535,10,FALSE,FALSE,191
37536,37727,9,FALSE,FALSE,191
37728,37823,10,FALSE,FALSE,95
37824,37871,5,FALSE,FALSE,47
37872,37919,6,FALSE,FALSE,47
37920,37967,7,FALSE,FALSE,47
37968,38015,8,FALSE,FALSE,47
38016,38399,10,FALSE,FALSE,383
38496,38591,5,FALSE,FALSE,95
38592,38687,4,FALSE,FALSE,95
38688,38783,2,FALSE,FALSE,95
38784,38879,1,FALSE,FALSE,95
38880,38975,2,FALSE,FALSE,95
38976,39167,10,FALSE,FALSE,191
39168,39263,9,FALSE,FALSE,95
39264,39647,10,FALSE,FALSE,383
